1111111111111111
1....2....4....1
1.H..2....4..E.1
1....2....4....1
1....2..L.4....1
1....2....4..K.1
1....2..Y.4....1
1....2....4....1
1....2....4....1
1....2....4....1
1....2....4....1
1....2....4....1
1....2....4....1
1P...2....4..T.1
1....2....4..M.1
1111111111111111