1111111111111111
1..B..H..W4....1
1..2...D..4.E..1
1..2......4....1
1..2..111.4....1
1..2..1...4.K..1
1..2..1.B......1
1......1....E..1
1......1.......1
1......1...11111
1......1.......1
1..333.1.......1
1..3...1.......1
1P.333.........1
1..............1
1111111111111111