1111111111111111
1............4T1
1..............1
1.............41
1..............1
1..............1
1..............1
1..............1
1..............1
1..............1
1..............1
1.MMMMMM.......1
1..............1
1..............1
1P.............1
1111111111111111